*********************************
*     *         *     * * * * * *
* *** * ******* * *** * * * * * *
* * * * * *   * * *           * *
* * * * * * *** * *** ***** * * *
* * * * * * *   * *       * *   *
* *** * *** *** * ******* *** * *
* *     *       *       *   * * *
* ******* ***** ******* * * * * *
* * *         *         * * * * *
* * * ***** *************** * * *
* * * *             * * * * * * *
* * * * ************* * * * * * *
*   * *                     * * *
* * * ************* * * * * * * *
* * *     *   *   * * * * * * * *
* * *** ***** *   ******* * * * *
* * * *     * *   *       * * * *
* * * *** *** *** * ******* * * *
* * *   *   *   *           * * *
*** * * *** * * *********** * * *
* * * *   *   *         * * * * *
* * * *** *** *** *** * * *** * *
* *   * * * *   *   * * *   * * *
* * * *** * *** *** *** * * * * *
* * * * *     *   *   *   * * * *
* *** * * * ***** *** ***** * * *
* * *     *   *     *         * *
* * * * * * * * *** *********** *
*     * * * * *               * *
* * * ***** ***** ******* *** * *
* * * *               *         *
*********************************