*********************************
*                               *
* ***************************** *
* *   *   *                     *
* * * * * * ************* *** * *
*   *   *   * *   *   *   *   * *
* * ******* * * * * * * *** *** *
* *       * *   *   *   *   * * *
* ******* * * * * * * *** *** * *
*     *   * * *   *   *   *   * *
***** * *** * ********* *** * * *
*   * *   * *   *     *     * * *
* * * *** * * * * *** ******* * *
* * *   * * * *   *         * * *
* * * *** * ******* ***** * * * *
* *   *   * * *   *       * * * *
* * *** *** * *   * *** * * * * *
* * *   * * *     * *   * * * * *
* *** *** * * ******* *** * * * *
*     *   * *           * * * * *
*** *** * * * ********* * * * * *
*     * * * *             *   * *
*** *** * * ************* *** * *
*     * * *             * *   * *
*** *** * * ********* * *** *** *
*     * * * *     *   *   *   * *
*** *** * *** *** * * * * *** * *
*       *       *   *   *   * * *
* ********* *** ******* *** * * *
*   *   *   *               * * *
* * * * * * *********** *** * * *
* *   *   *                 *   *
*********************************