*********************************
* *                       *     *
* *** * ***** * * ***** ***** * *
* *   *   *   * *   *         * *
* * ***** * *** *** * ***** *** *
*         *   * *   *   *     * *
* * ***** *** * * ***** *** * * *
* *   *   *         *   *   *   *
* *** * *** ***** * * * * ***** *
* *           *   * * *     *   *
* * * ***** * ******* *** * * * *
*   *   *   * *   *   *   *   * *
* ***** * *** *** * * * *** *** *
*       *   * *     *     *   * *
* * * ***** * * *** *** * * * * *
* * *         *   * *   *   *   *
*** *** ***** * * * * * *** *** *
* * *     *   *   *   * *   *   *
* * * ***** ******* ********* * *
*       *   *   *   * *   *   * *
* ***** * ***** ***** * * * *****
*   *             * *   *       *
*** * * ***** * *** *** ***** * *
* *   *   *   *   * *   * *   * *
* *** *** * ***** * * *** * *** *
* *   *       *         *     * *
* * * * ***** * ******* ***** * *
*   *     *       *   *         *
* * *** * ***** * * ***** * * * *
* * *   *   *   *         * * * *
* * * ***** * ***** ***** ***** *
* *                   *         *
*********************************