*********************************
*       * *                     *
* *** * * * * * ********* * *** *
* *   * * * * *         * *     *
* * * * * * * * ********* * *** *
* * * *   * *         * *       *
* * ***** * ***** *** * * ***** *
* *   *     *   * *   * * *   * *
* * * * ******* *** * * * * * * *
* * * *       * *   *   * * * * *
* * * * * *** * * * * * * *** * *
* * * * *     * * *   * *   * * *
* * * ********* * *** * * * * * *
* * *           *   * * * *     *
* * ***** ******* * * * * ***** *
*         *   *   *   * * *     *
* *** * * * * *   * *** * * *** *
* * * * * * * *   * * * * *     *
* * * * * * * ***** * * * * *** *
*   * * * * * *     *   *   * * *
* *** * * * * * * * *** *** * * *
*     * * * * * *               *
* * * * * * * *************** * *
* * * * * * * *               * *
* * * * * * * * ***** * ***** * *
*   * * * * * *     * * * * *   *
***** * * * * ***** ***** * * ***
*       * * *               * * *
* * *** * * * ********* *** * * *
* *   * *   *               * * *
* * *** *********************** *
* *                             *
*********************************
