*********************************
*                               *
* *** *** *** * ********* * *** *
* * * *   * * *         * *     *
* *** *** * * * ********* * *** *
* * * *   * * *       * *       *
* *** *** * *** * *** * * ***** *
*               * *   * * *   * *
* * * * ******* *** * * * * * * *
* * * *       * *   *   * * * * *
* * * * * *** * * * * * * *** * *
* * * *       * * *   * *   * * *
* * * *** ***** * *** * * * * * *
* * *           *   * * * *     *
* * ***** ******* * * * * ***** *
*             *   *   * * *     *
* *** * * * * *   * *** * * *** *
* * * * * * * *   * * * * *     *
* * * * * * * ***** * * * * *** *
*   * * * * *       *   *   * * *
* *** * * * * * * * *** *** * * *
*     * * * * * *               *
* * * * * * * * ************* * *
* * * * * * * *               * *
* * * * * * * * * * * * * *** * *
*   * * * * * * * * * * * * *   *
***** * * * * * * * * * * * * * *
*       * * *               * * *
* * *** * * * ********* *** * * *
* *   * *   *               * * *
* * *** ************* ********* *
* *                             *
*********************************
